
仙都=>仰止亭
六安=>马宗岭自然保护区
斯德哥尔摩=>市政厅,老城,皇后岛,音乐厅,瑞典皇宫,瓦萨博物馆,骑士岛,斯德哥尔摩大教堂,斯堪森公园
奈良县=>奈良公园
稻城=>亚丁,冲古寺,仙乃日,洛绒牛场,牛奶海,央迈勇,五色海,海子山,亚丁村,珍珠海,夏诺多吉,傍河,俄初山,茹布查卡,地狱谷,红草滩,奔波寺,郎吉岭寺,桑堆小镇,雄登寺,着杰寺,热乌寺
温德米尔=>格拉斯米尔
佛罗里达=>迈阿密南海滩
利马=>国家博物馆
滁州=>让泉
平谷县=>老象峰
奇旺=>国家公国
徐州=>龟山汉墓
株洲=>李立三故居
大连=>滨海国家地质公园,星海广场,老虎滩,滨海路,棒槌岛,星海公园,中山广场,傅家庄,旅顺口,圣亚海洋世界,东海公园,友好广场,俄罗斯风情街,森林动物园,燕窝岭,黑石礁,劳动公园,海之韵广场,人民广场,北大桥,大连港,贝壳博物馆,奥林匹克广场,发现王国主题公园,老铁山,金石园,自然博物馆,大黑山,十里黄金海岸,旅顺博物馆,旅顺军港,秀月峰,现代博物馆,中华武馆,白云山,日俄监狱旧址,横山书院,中苏友谊塔,狩猎俱乐部,营城子壁画墓,旅顺蛇博物馆,苏军烈士陵园,毛泽东像章陈列馆,万忠墓纪念馆,女骑警基地
景德镇=>瑶里,古县衙,龙珠阁,陶瓷馆,高岭山,陶瓷文化博览区,洪岩仙境,民窑博物馆
兰卡威=>红树林,巨鹰广场,巴雅岛,丹绒鲁海滩,珍南海滨,黑沙海滩,七仙井
芝加哥=>密歇根湖,西尔斯大厦,白金汉喷泉,密歇根大街,格兰特公园,林肯公园,约翰·汉考克中心
阿坝-若尔盖=>降扎温泉
赤峰=>达里诺尔湖,贡格尔草原,曼陀山庄,龙泉寺,巴林奇石馆,马鞍山国家森林公园,勃隆克沙漠旅游区,阿斯哈图冰石林,乌兰布统旅游区,青山冰臼群,真寂之寺,梵宗寺,辽中京遗址
蒙巴萨=>耶稣堡,察沃国家公园,拉姆岛
庆阳=>南梁革命纪念馆
南通=>支云塔
耶路撒冷=>哭墙,死海,橄榄山,圣墓教堂,锡安山,马撒达古堡,大卫城塔,以色列国家博物馆
马鞍山=>太白楼,雨山湖,三台阁,三元洞,翠螺山,林散之艺术馆,采石矶风景区,沿江栈道
弗里曼特尔=>南方大道
里昂=>老城,白莱果广场,细密画博物馆,圣让首席大教堂,卢米埃尔纪念馆,装饰艺术博物馆
马六甲市=>汉丽宝井
阿坝县=>格尔登寺,朗依寺
基督城=>库克山,艺术中心,植物园,教堂广场,艾芬河,南极中心,阿卡罗阿,岛屿湾,伊甸山,亚瑟山口,维多利亚广场
清莱=>清盛
邢台=>郭守敬纪念馆
林芝县=>鲁朗林海
波隆纳鲁沃=>帕拉克拉玛湖
伊犁=>果园
皮皮岛=>通赛湾,竹子岛,玛雅湾,蚊子岛,罗达拉木湾,维京洞穴,观景点,蓝通海滩
抚顺=>猴石森林公园
布鲁日=>梅姆灵博物馆
扎达=>托林寺
加那利群岛=>菲岛
丹东=>白石砬子自然保护区
昭通=>豆沙关,拖姑清真寺,野石山遗址
马赛马拉国家公园=>马赛马拉国家公园,马拉河,察沃国家公园,罗伊塔
三门峡=>函谷关
鄂东旅游区=>红三军团纪念馆
南宁=>德天瀑布,青秀山,明仕田园,伊岭岩,大明山,龙虎山,扬美古镇,良凤江,药用植物园,金花茶公园,花山壁画,凤凰湖,金伦洞,广西博物馆,南宁人民公园,南宁动物园,六景泥盆系剖面,石门森林公园,大龙湖,狮山公园,芦圩古镇
房山区=>石花洞
太阳城=>时光之桥
梧州=>邓公庙
慈利=>五雷山
溧阳=>太公山风景区
池州=>神仙洞
梵蒂冈=>圣彼得广场
丹巴=>丹巴美人谷
亳州=>万佛塔
因特拉肯=>少女峰,雪朗峰,何维克街,钟乳洞,荷黑马特
墨脱=>仁钦崩寺
丽水=>时思寺
巴塞罗那=>大教堂,米拉之家,西班牙广场,瓦伦西亚,毕加索博物馆,哥伦布纪念碑,圣家大教堂,国王广场,国家宫,阿马特耶之家,圣十字,帕尔马,奥林匹克港,诺坎普体育场,圣哈乌美广场,巴特约之家,塔比埃斯基金会,圣母玛利亚,高迪博物馆,莫雷拉之家,巧克力博物馆
平遥=>镇国寺,日升昌票号,明清一条街,清虚观,平遥古城墙,百川通,平遥文庙,华北一镖局,同兴公镖局,平遥城隍庙,古市楼,中国商会博物馆,协同庆票号
金门=>翟山坑道,金门民俗文化村,金门慈湖
开罗=>萨卡拉金字塔
普洱=>倒生根公园
蚌埠=>张公山
营口=>望儿山,楞严禅寺,月亮湖公园
石景山=>法海寺
墨西哥城=>国家宫
六盘水=>玉舍森林公园
雅安=>二郎山,碧峰峡,上里古镇,蒙顶山,夹金山,青衣江,白马泉,望鱼古镇,东拉山大峡谷,周公山温泉公园,灵鹫山,蜂桶寨自然保护区,百丈湖
威海=>刘公岛,成山头,国际海水浴场,海驴岛,甲午战争博物馆,威海公园,天鹅湖,定远舰,法华院,乳山银滩,始皇庙,环翠楼公园,石岛湾,铁槎山,甲午海战纪念馆,圣经山,圣水观,乳山口,正棋山
苏滋达里=>克里姆林宫
哈瓦那=>巴拉德罗海滩
石景山区=>慈善寺
桑植=>九天洞
大同=>悬空寺,恒山,云冈石窟,华严寺,九龙壁,善化寺,鼓楼,大同火山群,平型关,关帝庙,永安寺,观音堂,万人坑,水神堂,赵武灵王墓,慈云寺,灵丘古道
新疆=>乌鲁木齐站
常熟=>辛峰亭
丽江=>万古楼
清州=>相洙香草乐园
太原=>晋祠,圣母殿,双塔寺,迎泽大街,难老泉,晋祠公园,汾河,崇善寺,鱼沼飞梁,献殿,白塔,天龙山石窟,山西博物院,迎泽公园,纯阳宫,山西省博物馆,崛围山,龙山石窟,汾河公园,大佛寺,太原动物园,晋祠龙山,多福寺
内罗毕=>肯尼亚国家博物馆
林道=>林道市港口
基隆=>和平岛滨海公园
上饶=>灵山
酒泉=>博物馆,卫星发射基地,钟鼓楼,大法幢寺
葫芦岛=>兴城海滨,菊花岛,止锚湾,葫芦山庄,首山,虹螺山,龙潭大峡谷,龙湾海滨滑雪场,望海寺
通化=>四季生态园
门头沟=>百花山
香港=>中环,铜锣湾,海洋公园,旺角,迪士尼,湾仔,尖沙嘴,星光大道,太平山顶,浅水湾,兰桂坊,天星小轮,东涌,维港,赤柱,大屿山,油麻地,西贡,上环,会议展览中心,金紫荆广场,幻彩咏香江,长洲,天坛大佛,大澳,香港大学,太空馆,杜莎夫人蜡像馆,美利楼,黄金海岸,黄大仙祠,青马大桥,清真寺,皇后像广场,科学馆,香港文化中心,梅窝,九龙公园,香港体育馆,午炮,深水湾,文武庙,湿地公园,石澳,张保仔,跑马地赛马场,礼宾府,奥运马术比赛场,麦理浩径,飞鹅山
花垣=>古苗河
阿布扎比=>人工岛,皇宫酒店,扎耶德清真寺
赣州=>潋江书院
咸阳=>乾陵,茂陵,昭陵,汉阳陵,咸阳博物馆,杨贵妃墓,彬县大佛寺,城隍庙,甘泉宫遗址,昭仁寺
南迪=>金银岛
斯特拉斯堡=>大教堂,欧洲议会,小法兰西,罗昂宫
阿格拉=>Taj Mahal,Agra Fort
富山县=>立山黑部
楠溪江=>石桅岩,狮子岩,林坑,大若岩,石门台,小三峡,陶公洞,芙蓉古村,岭上人家,崖下库,龙湾潭,百丈瀑,苍坡古村,龙瀑仙洞,丽水古街,珍溪,藤溪瀑布群,花坦村,太平岩,四海山,望兄亭,埭头古村,芙蓉三崖,焦岩圣迹
晋城=>拴驴泉
都江堰市=>都江堰,青城山
红河=>屏边大围山
嵩山=>少林寺,塔林,三皇寨,嵩阳书院,少室山,中岳庙,太室山,峻极峰,嵩岳寺塔,观星台,法王寺,达摩洞,永泰寺,卢崖瀑布,二祖庵,连天峰,老母洞,汉三阙,轩辕关,汉封将军柏,初祖庵大殿
里约热内卢=>瓜纳巴拉湾,马拉卡纳足球场,巴西中央文化中心
明月山=>南方铁杉
五台山=>黛螺顶,显通寺,菩萨顶,塔院寺,南山寺,殊像寺,佛母洞,龙泉寺,金阁寺,佛光寺,碧山寺,南禅寺,万佛阁,镇海寺,锦绣峰,普化寺,灵鹫峰,竹林寺,挂月峰,灵应寺,望海峰,叶斗峰,翠岩峰,广宗寺,尊胜寺,般若泉,圆照寺,十方堂,阎锡山旧居,梵仙山,寿宁寺
乌兰浩特=>葛根庙
青岛=>崂山,栈桥,八大关,五四广场,花石楼,小青岛,北九水,鲁迅公园,极地海洋世界,一海水浴场,海军博物馆,天主教堂,太清宫,海底世界,基督教堂,奥帆中心,中山公园,迎宾馆,信号山,小鱼山,二海水浴场,啤酒城,巨峰,薛家岛,公主楼,啤酒博物馆,上清宫,湛山寺,田横岛,明霞洞,琅琊台,天幕城,元帅楼,龙潭瀑,雕塑园,植物园,大珠山,高凤翰纪念馆,海尔科技馆,海尔工业园,八关山,山炮台遗址,青岛市博物馆,大泽山公园
乌特勒支=>德哈尔古堡
三河=>三河市人民公园
武义=>清风寨
张家口=>赤城温泉
伊兹密尔=>考古博物馆
格拉纳达=>阿尔拜辛区
阿德莱德=>墨累河,格雷尔
芽庄=>龙山寺
绍兴=>沈园,兰亭,鲁迅故里,三味书屋,东湖,柯岩,咸亨酒店,百草园,鉴湖,仓桥直街,大禹陵,鲁镇,安昌古镇,八字桥,鲁迅纪念馆,青藤书屋,吼山,嵊州,卧龙山,秋瑾故居,城隍庙,古纤道,镜湖,蔡元培故居,绍兴一中,瓜渚湖,师爷馆,城隍殿,土谷祠,香林花雨,书圣故里,百丈飞瀑,印山王陵,西小河
卑尔根=>鱼市
代尼兹利=>棉花堡
阳泉=>藏山,滴水岩
南浔=>小莲庄,百间楼,嘉业堂藏书楼,张静江故居,颖园,刘氏梯号,张石铭旧宅,求恕里,广惠桥,丝业会馆,通津桥,刘氏家庙,广惠宫
和歌山县=>三段壁
额济纳=>胡杨林,怪树林,神树,黑水城,黑城遗址,东风航天城
阳江=>海陵岛,大角湾,十里银滩,马尾岛,阳江温泉,月亮湾,东方银滩,玉溪三洞,东湖旅游区,石觉寺,石林
齐齐哈尔=>龙沙公园,大乘寺,清真寺,二克山,水师森林公园,红岸公园,扎龙
康提=>佩拉德尼亚
黄山=>水口塔
达沃斯=>蒙施泰因
安吉=>赋石水库
莱比锡=>托马斯教堂,老市政厅,尼古拉教堂,德意志图书馆,巴赫博物馆
泉州=>净峰寺
阿坝-四姑娘山=>三姑娘山
龙目岛=>陶器村
安特卫普=>大广场,鲁本斯故居,钻石博物馆,圣母大教堂,海洋博物馆
布达佩斯=>马加什教堂
奥斯陆=>市政厅,王宫,弗洛姆,国家剧院,阿肯修弗斯城
朝阳=>劈山沟
日内瓦=>日内瓦湖,花钟,万国宫,圣彼得大教堂,印刷所,红十字会博物馆
同里=>退思园,三桥,罗星洲,崇本堂,嘉荫堂,珍珠塔,耕乐堂,陈去病故居,松石悟园,世德堂,肖甸湖,南园茶社,丽则女学,影视基地,长山岚翠,文物陈列馆
阿姆斯特丹=>运河,风车村,库肯霍夫,王宫,水坝广场,中央车站,Marken,凡高博物馆,西教堂,阿克马,花街,凡高美术馆,安妮之家,edam,皇家音乐厅,冯得尔公园,喜力啤酒博物馆
黔东南=>从江,榕江,岜沙,千户苗寨,舞阳河,小黄,郎德上寨,雷公山,台江,剑河,车江侗寨,香炉山,舟溪芦笙堂,凯里民族博物馆,高增侗寨,渔洞溶洞,麻塘革家
阿尔山国家森林公园=>石塘林
罗托鲁瓦=>彩虹泉公园
武汉=>东湖,长江大桥,珞珈山,户部巷,江汉路,归元寺,博物馆,植物园,古琴台,汉正街,湖北省博物馆,晴川阁,木兰天池,武昌起义纪念馆,中山公园,木兰山,动物园,九宫山,黄鹤楼公园,荆州古城,赤壁古战场,梁子湖,江滩公园,铁门关,长春观,解放公园,陆水湖,宝通禅寺,东湖海洋世界,首义广场,洪山广场,禹稷行宫,国民政府旧址,大洪山风,赤壁龙佑温泉,吉庆街
普罗旺斯=>断桥,波城古堡,圆形竞技场,塞尚画室,米拉波大道,都德的风车,圣苏维尔大教堂,新城
苏梅岛=>涛岛,拉迈海滩,查武恩海滩,那通镇,大佛海滩,祖父祖母石,帕雅寺
拉斯维加斯=>大峡谷,马戏团,迪士尼,长街,美丽湖饭店,刚多拉,神秘园,海盗船及女妖大战,天空步道,纪念谷
嘉峪关=>关城,七一冰川,悬壁长城,长城一墩,内城,长城博物馆,罗城,游击将军府,关帝庙,魏晋壁画墓,文昌阁,滑翔基地,西长城,东瓮城,九眼泉,角楼
大阪=>大阪城,心斋桥,梅田,道顿堀,海游馆,美国村,日本环球影城,电器街,四天王寺,天满宫,天保山,历史博物馆,新世界,难波宫,黑门市场,住吉大社,北新地,千日前,万博纪念公园,浮世绘馆,空中庭园展望台
华山=>鹞子翻身
汉堡=>市政厅,仓库城,阿尔斯特湖,汉堡港,吕贝克,拱廊,少女堤,米歇尔教堂,民俗博物馆,哈根贝克动物园,艺术博物馆,智利屋
澳门=>威尼斯人度假村,大三巴牌坊,澳门博物馆,议事亭前地,妈阁庙,关闸,渔人码头,主教座堂,大炮台,旅游塔会展娱乐中心,东望洋炮台,玫瑰圣母堂,海事博物馆,澳门历史城区,龙环葡韵住宅式博物馆,黑沙海滩,金莲花广场,大赛车博物馆,圣老楞佐堂,卢廉若公园,三街会馆,艺术博物馆,亚婆井前地,圣母雪地殿教堂,国父纪念馆,二龙喉,主教山小堂,何东图书馆,白鸽巢前地,圣若瑟修院及圣堂,东方基金会会址,螺丝山公园,菩堤园,望德圣母堂,妈阁炮台,嘉谟圣母教堂
开普敦=>水门区
惠州=>香溪堡
格拉茨=>穆尔岛,城堡山,军械库,城市公园,大钟塔,埃根博格城堡
张掖=>龙首山
鹿特丹=>立体方块屋,德夫哈芬,马仕朗防风暴大坝,海事博物馆,博曼斯美术馆
承德=>避暑山庄,普宁寺,普陀宗乘之庙,金山岭长城,须弥福寿之庙,丽正门,雾灵山,烟雨楼,普乐寺,双塔山,安远庙,文津阁,万树园,金山,如意洲,澹泊敬诚,京北一草原,魁星楼,万壑松风,水心榭,松鹤斋,月色江声,蛤蟆石,云山胜地,溥仁寺,白云古洞,春好轩,热河城隍庙,罗汉山
杨镇=>国际鲜花港
海防=>吉婆岛
福州=>三坊七巷,闽江,鼓山,马尾,南后街,涌泉寺,乌山,西湖公园,青云山,塔巷,开元寺,五一广场,光禄坊,衣锦坊,吉庇巷,西禅寺,黄巷,郎官巷,罗星塔,宫巷,安民巷,屏山,摩崖石刻,白塔,喝水岩,江滨公园,左海公园,金牛山,大士殿,朱紫坊,定光塔寺,五虎山,天王殿,半洋石帆,万福寺,千佛陶塔,达摩十八景,香积厨,补山精舍
宜兴=>西施洞
宜兰=>吴沙故居
西塘=>烟雨长廊,石皮弄,来凤桥,永宁桥,环秀桥,西园,烧香港,醉园,安境桥,七老爷庙,圣堂,卧龙桥,种福堂,薛宅,五福桥,尊闻堂,酒文化博物馆,木雕馆,坟浜弄,东岳庙,瓦当陈列馆,药师庵
江原道=>尺山温泉
四平=>山门风景区
安波塞利=>东非大裂谷
商洛=>洛南文庙
巴西利亚=>巴西利亚电视塔
鞍山=>千山,玉佛苑,汤岗子温泉,千山温泉,千山大佛,药山
厦门=>鼓浪屿,日光岩,厦门大学,南普陀寺,菽庄花园,山炮台,皓月园,日月谷,鳌园,集美学村,钢琴博物馆,同安,风琴博物馆,园林植物园,海底世界,海天堂构,龙舟池,中山公园,海沧大桥,毓园,木栈道,嘉庚公园,海滨浴场,琴园,郑成功纪念馆,厦门大桥,园博园,白鹭洲公园,五缘湾,万石山,万石岩,国际会展中心,民俗文化村,厦门博物馆,虎溪岩,海湾公园,天竺山,翠丰温泉,英雄三岛,白鹿洞,青礁,金榜公园,梵天寺,鳄鱼园,华侨博物院,战地观光园,青少年科技馆,园林博览苑,湖里公园,观光大道
广元=>明月峡栈道
瑞安=>测试
宋卡=>宋卡湖
攀枝花=>长江国际漂流基地
衡水=>衡水湖
松潘=>长征纪念碑
冲绳=>守礼门
临汾=>壶口瀑布,尧庙,广胜寺,洪洞大槐树,苏三监狱,尧陵,小西天,雁塔,丁村遗址,牛王庙戏台,平阳鼓楼,襄汾造像碑
京畿道=>仁川中华街
临沂=>王羲之故居
槟城=>极乐寺,唐人街,槟威大桥,植物园,蛇庙,槟榔山,卧佛寺,蝴蝶园,印度庙,缅佛寺,观音寺,艺术博物馆,弥勒寺
宣城=>踏歌岸阁
临沧=>茶文化风情园
全罗南道=>宝城绿茶园
延安=>壶口瀑布,宝塔山,黄帝陵,南泥湾,清凉山,延安革命纪念馆,凤凰山,万花山,孟门山,枣园革命旧址,延安新闻纪念馆,杨家岭革命旧址,政府礼堂
哥本哈根=>步行街,市政厅广场,美人鱼铜像,大理石教堂,趣伏里公园,国王新广场,克隆堡宫,国家博物馆,皇宫广场,安徒生铜像,阿玛莲堡,洛森堡宫
南投=>玉山公园
海南东线=>吊罗山
曼彻斯特=>阿戴尔中心
雪乡=>双峰林场,镜泊湖,地下森林,威虎山,吊水楼瀑布,渤海国上京龙泉府遗址
全罗北道=>禅云寺
康定=>新都桥,海螺沟,二郎山,木格措,贡嘎山,泸定桥,跑马山,塔公草原,塔公寺,七色海,燕子沟,情歌风景区,金刚寺,杜鹃峡,药池沸泉,二道桥温泉,南无寺,郭达山,木雅金塔,公主桥,水井子,莲花海,安觉寺
顺化=>顺化皇城,圣母大教堂,天姥寺,启定皇陵,明命皇陵,嗣德皇陵
鲁汶=>鲁汶大学,圣彼得大教堂
奥克兰=>天空塔,伊甸山,萤火虫洞,海港大桥,奥克兰博物馆,独树山,凯利塔顿,女王大街,米弗峡湾,奥克兰公园
聊城=>东昌湖,光岳楼,山陕会馆,景阳冈,曹植墓,凤凰苑农业科技园
波罗斯岛=>波罗斯岛
斋浦尔=>老虎堡
皇后镇=>Wakatipu,蒂阿瑙,Kawarau,瓦尔特,峡湾国家公园,路特本远足径
罗平=>罗平
布拉迪斯拉发=>总统府
斯里巴加湾市=>水上村落
张家界=>土家风情园,桑植,老院子,龙王洞,秀华山馆,江垭温泉,贺龙故居,黄龙泉,玉皇洞,苏维埃纪念馆
庆州=>佛国寺,石窟庵,大陵苑,雁鸭池,瞻星台,南山,国立庆州博物馆,石冰库,五陵,古坟公园
洛杉矶=>好莱坞,星光大道,迪士尼,好莱坞环球影城,日落大道,圣莫尼卡,罗迪欧大道,中国戏院,圣地亚哥海洋世界,洛杉矶市政厅,农夫市场,郡立美术馆,斯台普斯球馆,露天音乐厅,美籍日本人国家博物馆,威尼斯海滩
安卡拉=>罗马剧场
仁川=>中央公园
都灵=>汽车博物馆
会安=>日本廊桥
马六甲=>葡萄牙广场
阳朔=>西街,遇龙河,杨堤,月亮山,大榕树,印象刘三姐,九马画山,遇龙桥,富里桥,世外桃源,蝴蝶泉,十里画廊,聚龙潭,兴坪古镇,龙门水岩,黄布倒影,碧莲峰,仙桂桥,骆驼过江,菩萨水岩,书童山,愚自乐园,莲花岩,山水园,月亮水岩,古石城,徐悲鸿故居,独山,刘三姐水上公园,东郎山,曹邺读书岩,秀才看榜
柳州=>东门城楼
遵义=>娄山关,遵义会议会址,习水,茅台镇,红军山,四洞沟,赤水丹霞,丙安古镇,赤水大瀑布,播雅天池,小西湖,桫椤王国,燕子岩森林公园,海龙囤遗址
京都=>清水寺,金阁寺,岚山,二条城,祗园,东大寺,平安神宫,银阁寺,天龙寺,龙安寺,三千院,西阵织会馆,三十三间堂,京都御所,仁和寺,醍醐寺,平等院,建仁寺,四条河原町,永观堂,产宁坂,东福寺,北野天满宫,真如堂,平野神社
光州=>乐安邑城民俗村
广岛县=>严岛神社
伊尔比德=>北部剧院
烟台=>长岛,九丈崖,昆嵛山,养马岛,芝罘岛,金沙滩,仙境源,牟氏庄园,烟台山公园,毓璜顶公园,崆峒岛,万鸟岛,宝塔礁,龙口南山,林海公园,万米海滩浴场,芝罘阳主庙,历史博物馆,天地广场,雕塑园,天街广场,福建会馆,寒同山,丁氏故宅
益阳=>梓山湖
济源=>济渎庙
赫尔辛基=>大教堂,芬兰堡,岩石教堂,西贝柳斯公园,艾斯堡,图尔库城堡,议会广场,曼纳林博物馆
大兴安岭=>映山红滑雪场,北山公园,呼玛河口,画山,白银纳鄂伦春,大白山
台州=>观夕洞
茂=>茂森林公园
汕头=>桑浦山
南充=>罗瑞卿故居
开城=>板门店
满洲里=>火车头广场
西双版纳=>民俗活动村
湖州=>飞英公园
新加坡=>圣淘沙,小印度,莱佛士,新加坡河,克拉码头,环球影城,唐人街,清真寺,音乐喷泉,滨海艺术中心,新加坡动物园,驳船码头,裕廊飞禽,夜间野生动物园,兴都庙,鱼尾狮像,鱼尾狮塔,花柏山,阿拉伯街,乌敏岛,胡姬花园,武吉知马,天福宫,海洋生物园,万象馆,马来村,新加坡美术馆,世界昆虫馆,东海岸公园,龟屿岛,虎豹别墅,海事博物馆,旧国会大厦,西乐索炮台,莱佛士登岸遗址,和平纪念碑,新加坡历史博物馆
岐阜县=>马笼宿
邯郸=>天子冢
理县=>古尔沟温泉
剑桥=>剑桥大学,剑河,国王学院,叹息桥,数学桥,圣约翰学院,圣三一学院,莎翁故居,麦格达伦学院
河源=>龟峰塔
屏东=>鹅銮鼻公园
莫干山=>武陵村
神农架=>神农顶,板壁岩,燕子垭,滑雪场,香溪源,红坪画廊,风景垭,天门垭,金猴岭,燕天,神农祭坛,燕子洞,老君山,了望塔,小当阳,古犀牛洞,六道峡,自然博物馆,武山湖,龙潭野考站,高山湿地
蒙特利尔=>旧城区,美术馆,皇家山公园,自然生态博物馆,蒙特利尔植物园,蒙特利尔美术馆,卡耶广场,艺术广场
布宜诺斯艾利斯=>五月广场,阿根廷湖,巴拉那河,科隆大剧院,国会广场,玫瑰园,马德普拉塔
淮安=>天文科普园
戛纳=>影节宫,城堡美术馆
巴斯克=>潘普洛纳
石家庄=>苍岩山,赵州桥,抱犊寨,嶂石岩,天桂山,石头村,柏林禅寺,博物馆,荣国府,清凉山,五岳寨,木塔,毗卢寺,福庆寺,封龙山,青塔,西柏坡中共中央旧址,碧涧灵檀,幽居寺塔,蟠龙湖,探险乐园
石河子=>巴音山庄
黑水县=>客龙沟,奶子沟,色尔古藏寨
溪口=>亭下湖
信阳=>净居寺
大理=>千狮山
茂县=>叠溪,叠溪地震遗址,羌族博物馆
黄金海岸=>冲浪者天堂,华纳电影世界,海洋世界,激浪世界,可伦宾野生动物园,木星赌场
根特=>钟楼
圣加仑=>纺织品博物馆
比勒陀利亚=>联合大厦
道孚=>八美
平凉=>石拱寺
潮州=>人民广场
嘉兴=>钱君匋艺术院
敦煌=>莫高窟,鸣沙山,玉门关,汉长城,博物馆,西千佛洞,榆林窟,河仓城,雅丹地质公园,雷音寺,白马塔,锁阳城,阳关遗址,渥洼池,故城,沙漠森林公园,寿昌城,三危圣境,桥湾城
宝鸡=>龙门洞
南阳=>南阳五朵山风景区
长沙=>岳麓山,湘江,岳麓书院,橘子洲,爱晚亭,天心阁,湖南省博物馆,烈士公园,麓山寺,开福寺,花明楼,海底世界,一师范,云麓宫,白鹤泉,半山亭,动物园,大围山,白沙井,禹王碑,石燕湖,赫曦台,晓园公园,沩山,黄兴墓,蟒蛇洞,笑啼崖,铜官窑,舍利塔,简牍博物馆,月亮岛,杨开慧故居,马王堆汉墓遗址,贾谊故宅,观音崖
沈阳=>棋盘山,清昭陵,张氏帅府,怪坡,北陵公园,棋盘山冰雪大世界,沈阳世博园,动物园,中山广场,东北亚滑雪场,实胜寺,关东影视城,辽宁省博物馆,东陵公园,金融博物馆,蒸汽机车博物馆,铸造博物馆,中山公园,长安寺,新乐遗址博物馆,抗美援朝烈士陵园,般若寺,辽滨古城,北塔碑林,永安桥,清沈阳故宫,苏联红军阵亡将士纪念碑,彩电塔
马丘比丘=>帕拉卡斯自然保护区
约克=>印象艺廊
坎昆=>奇琴伊察,瓜达路佩寺院,图伦遗址
延庆县=>硅化木地质公园
克久拉霍=>西庙群
平顶山=>尧山
合肥=>袁术古堆墓
宜宾=>五粮液酒厂
德宏=>佛光寺
井冈山=>茨坪,黄洋界,五指峰,大井,笔架山,水口,小井,井冈山革命博物馆,黄洋界哨口,八角楼,五大哨口,井冈山烈士陵园,茨坪革命旧址群,龙潭瀑布,十里杜鹃长廊,五马朝天,金狮面,石燕洞
渤海镇=>卧佛山
布里斯班=>野生动物园
庞贝=>露天剧场
阿拉善盟=>腾格里沙漠
科右前旗=>察尔森湖
甲米=>奥南海滩,兰达岛,石灰石山,莱雷海滩,拉塔拉海滩,高番本查
山南=>琼果杰寺
艾伊娜岛=>艾伊娜岛
鄂尔多斯=>成吉思汗陵,响沙湾,鄂尔多斯草原旅游区,鄂尔多斯文化旅游村,乌审召
贝希特斯加登=>国王湖
西安=>兵马俑,大雁塔,华清池,钟楼,北院门,鼓楼,骊山,大唐芙蓉园,小雁塔,秦始皇陵,陕西历史博物馆,书院门,西安事变,碑林博物馆,清真大寺,汤峪,大雁塔广场,青龙寺,翠华山,明城墙,临潼博物馆,半坡遗址,德福巷,曲江池,大明宫遗址,湘子庙,西安博物院,兴庆宫公园,楼观台,九龙潭,八仙庵,海洋世界,寒窑,南五台,高家大院,王顺山,鸿门宴遗址,嘉午台,广仁寺,香积寺,扁鹊墓,户县农民画,革命公园,辋川溶洞,渭水园,汉长安城遗址,化羊庙,杨虎城别墅,广新园民族村,太兴山
普兰=>温泉湖
西宁=>塔尔寺,日月山,坎布拉,清真大寺,循化,孟达天池,北禅寺,马步芳公馆,互助土族,湟水河,老爷山,人民公园,儿童公园,北山森林公园,药水滩,柳湾墓地,佑宁寺,西宁植物园,湟中县博物馆
库特纳霍拉=>人骨教堂
重庆=>解放碑,磁器口,洪崖洞,大足石刻,仙女山,渣滓洞,红岩,小三峡,南山,乌江,四面山,芙蓉洞,金佛山,缙云山,黑山谷,金刀峡,统景,人民大礼堂,芙蓉江,钓鱼城,北温泉,黄山,龚滩古镇,南温泉,偏岩古镇,小南海,乌江画廊,湖广会馆,朝天门广场,白鹤梁,天赐温泉,曾家岩,动物园,南湖,涞滩古镇,万盛石林,天坑三桥,龙潭古镇,雪玉洞,南山植物园,枇杷山,华岩寺,桂园,野生动物世界,宁厂古镇,石夹沟,卫星湖,青龙湖,黄水,仙渡溶洞
茵斯布鲁克=>时钟博物馆
小金=>夹金山
辽阳=>辽阳博物馆
西雅图=>派克市场,太空针塔,西雅图音乐体验馆,太平洋科学中心,地下城,奥林匹克国家公园,西雅图美术馆,北瀑布国家公园
呼和浩特=>喇嘛洞召
阜阳=>八里河风景区,颖州西湖,文峰塔,竹音寺
婺源=>李坑,江岭,理坑,彩虹桥,庆源,思溪,延村,江湾,汪口,大鄣山,虹关,长溪村,鸳鸯湖,月亮湾,洪村,文公山,上下晓起,婺源博物馆,丛溪漂流,凤游山,经义堂,古戏台,五龙山,灵岩洞森林公园,龙天宝塔
复活节岛=>拉帕努伊国家公园
巴拉望=>帕玛里肯岛
安顺=>天星桥,黄果树瀑布,龙宫,陡坡塘瀑布,石头寨,夜郎洞,观音洞,安顺文庙,紫云格凸河,黄果树漂流,红崖古迹,花江大峡谷
漳州=>怀远楼
本溪=>天龙洞
亚的斯亚贝巴=>青尼罗河瀑布
暹粒=>女王宫,巴肯山,崩密列,巴戎寺,吴哥寺,洞里萨湖,圣剑寺,皇家浴池,通王城,比粒寺,高布斯滨,罗洛士群,茶胶寺,周萨神庙,东梅奔,荔枝山,塔布茏寺,豆蔻寺,龙蟠水池,斑黛喀蒂,塔逊,西池,托玛侬神庙,西梅奔,科荣寺
永定=>茅岩河,普光禅寺
张山营镇=>古崖居
波士顿=>哈佛大学,唐人街,儿童博物馆,自由之路,波士顿公园,州议会大厦,后湾,美国麻省理工学院,波士顿公共图书馆,旧北教堂,波士顿茶事件纪念馆,艺术博物馆
当雄=>羊八井
亚历山大=>庞贝柱
广东=>广州站
釜山=>海云台,太宗台,龙头山,梵鱼寺,国际市场,札嘎其市场,光复洞,龙宫寺,东莱温泉,上海牌楼,通度寺,镇海市,南浦洞街,釜谷温泉
固原=>堡子山
珀斯=>鲨鱼湾,蒙格湖
东京=>新宿,银座,浅草寺,台场,皇居,涩谷,东京塔,池袋,歌舞伎町,二重桥,明治神宫,筑地市场,国立博物馆,新宿御苑,草津温泉,彩虹乐园,东京博物馆,都厅展望台,吉卜力美术馆,科学未来馆,千鸟之渊,仲见世街
海牙=>和平宫,马德罗丹,席凡宁根,国会大厦,代尔夫特,豪达,梅斯达
永定区=>天门山
克拉玛依=>黑油山
米兰=>大教堂,科莫湖,斯卡拉剧院,感恩圣母堂,佩佐利美术馆,梅尔康提广场
卢加诺=>老城区
百色=>云台山
长治=>灵空山,黄崖洞,老顶山,五凤楼,花坡,仙堂山,九天圣母庙,玉皇观
湘西=>陈氏古宅
杭州=>西湖,灵隐寺,西溪,白堤,九溪,钱塘江,飞来峰,花港观鱼,孤山,杨公堤,曲院风荷,岳庙,六和塔,柳浪闻莺,清河坊,宋城,博物馆,三潭印月,余杭,梅家坞,平湖秋月,茅家埠,吴山广场,太子湾,西湖天地,断桥残雪,满陇桂雨,郭庄,玉泉,云栖竹径,苏堤春晓,万松书院,南屏晚钟,山沟沟,胡雪岩故居,动物园,龙井问茶,印象西湖,雷峰夕照,钱王祠,凤凰山,五云山,保俶塔,双峰插云,径山,湘湖,吴山天风,白塔,三台阁
衡阳=>方广寺
普吉岛=>攀牙湾,芭东海滩,普吉镇,幻多奇,珊瑚岛,皇帝岛,卡隆海滩,卡塔海滩,卡马拉海滩,奈阳海滩,查龙寺,斯里纳斯,乡村俱乐部,奈汉海滩,通赛瀑布,蓝峡谷
凯恩斯=>大堡礁,库兰达,棕榈湾,查普凯,热带雨林公园,野生世界,费兹洛伊岛,格瑞夫特
贺州=>秀水状元村
龙山=>乌龙山
金川=>嘎达山
怀化=>恭城书院
平壤=>大城山
济州岛=>泰迪熊博物馆,牛岛,天地渊瀑布,山君不离,如美地植物园,民俗村博物馆,城板岳,药泉寺,游览船,神奇之路,中文海水浴场,汉拿树木园,新罗饭店赌场,迷路园,山房窟寺,五层石塔
汉诺威=>莱纳河城堡
薄荷岛=>眼镜猴游客中心
保定=>乌龙沟
朝阳市=>古生物化石地质公园
张坊镇=>云居滑雪场
长海=>大长山岛,哈仙岛,三元宫,祈祥园,仙女湖,瓜皮岛,海洋岛
温哥华=>斯坦利公园,唐人街,盖士镇,温哥华水族馆,哥伦比亚冰原,加拿大广场,乔治亚海峡,卡皮拉诺吊桥公园,温哥华美术馆,英吉利湾,人类学博物馆,松鸡山
哈密=>寒气沟
贝尔法斯特=>贝尔法斯特,巨人之路,布什米尔斯
湘潭=>毛泽东故居
郑州=>黄河,河南博物院,黄帝故里,商城遗址,康百万庄园,城隍庙,森林公园,动物园,始祖山,黄河博物馆,打虎亭汉墓,北宋皇陵,石窟寺,黄河谷,慈云寺,黄帝宫,河洛汇流
万象=>翁得寺
阿尔山=>温泉,阿尔山森林公园,火车站,好森沟,滑雪场,白狼林俗村
莱芜=>龙山风景区,文昌岛景区
库尔勒=>铁门关
昌都=>查杰玛大殿
毕节=>草海,织金洞,百里杜鹃,韭菜坪,九洞天,乌江源百里画廊,大屯土司庄园,可乐遗址,奢香博物馆
韶山=>滴水洞,毛泽东故居,韶峰,花明楼,毛泽东纪念馆,毛泽东诗词碑林,毛泽东纪念园,毛泽东图书馆,湘潭农博园
恩施=>清江闯滩
防城港=>江山半岛,十万大山,万尾金滩,峒中温泉,胡志明小道
巴中=>川陕革命根据地博物馆
哈尔滨=>中央大街,太阳岛,冰雪大世界,松花江,欧亚之窗,玉泉狩猎场,玉泉威虎山森林公园,亚布力滑雪,防洪纪念塔,极地馆,兆麟公园,圣索菲亚,斯大林公园,东北虎林园,风车山庄,龙塔,冰灯游园会,二龙山,极乐寺,动物园,游乐园,二龙山滑雪场,松峰山,伏尔加,狩猎场,萧红故居,九站公园,森林植物园,都滑雪场,月亮湾,七级浮屠塔,长寿山滑雪场,巴兰河漂流,黑龙江纪念馆,阎家岗旧石器时代遗址,民族博物馆,尚志碑林
永顺=>芙蓉镇
廊坊=>北野烟林
大溪地=>波拉波拉,茉莉雅岛
盘锦=>湖滨公园
库车=>龟兹古城
马赛=>旧港,伊夫岛,隆尚宫,修道院,美术馆,圣母加德大教堂
加德满都=>猴庙,蓝毗尼,独木庙,博达哈大佛塔,那加阔特,加德满都杜巴广场,巴德岗杜巴广场,尼亚塔波拉庙,帕斯帕提那神庙,陶器广场,萨加玛塔国家公园,帕坦王宫,帕坦博物馆,童女神庙
西沙群岛=>永兴岛,永乐群岛,七连屿,东岛,海洋博物馆
山梨县=>河口湖
茵莱湖=>掸族首领博物馆
图卢兹=>南运河
海南中线=>仙安石林
常德=>常德诗墙
阿里=>冈仁波齐
周庄=>双桥,沈厅,张厅,南湖,迷楼,沈万三故居,怪楼,澄虚道院,叶楚伧故居,太平桥,文化街,周庄舫,水冢,大诚堂,棋苑,全福塔
北领地=>红中心
格拉斯哥=>乔治广场,布雷尔收藏馆,格拉斯哥大教堂
台中=>武陵农场
渭南=>渭南鼓楼
多伦多=>多伦多大学,尼亚加拉瀑布,央街,唐人街,圣劳伦斯市场,圣罗伦斯河,新市政厅,安大略皇家博物馆,多伦多动物园,活拜娱乐场,天顶大厦
波尔多=>圣米歇尔教堂,大剧院,坎康斯广场,考古学博物馆,市立美术馆
花莲=>南滨公园
宣武区=>大观园
吕梁=>酒都杏花村
汶川=>萝卜寨
渥太华=>国会大厦
台东=>东河桥
晋中=>乌金山
佛罗伦萨=>圣母百花大教堂,锡耶纳,米开朗基罗广场,圣十字教堂,乔托钟楼,皮蒂宫,韦奇奥宫,市政厅广场,蒙特卡蒂尼,乌费兹美术馆,圣乔万尼洗礼堂,法拉利博物馆,阿卡德米亚
洛阳=>龙门石窟,白马寺,关林,白园,香山寺,王城公园,古墓博物馆,白云山,牡丹公园,西苑公园,洛阳博物馆,神州牡丹园,国色牡丹园,重渡沟,天子驾六博物馆,鸡冠洞,洛浦公园,青要山,民俗博物馆,龙峪湾,山陕会馆,神灵寨,汉魏故城,广化寺,木札岭,天池山,汉光武陵,杜甫墓,观音寺,白云观
尼甘布=>圣玛丽教堂
铁岭=>龙首山,象牙山,清河旅游度假区,慈清寺,榛子岭水库
科尔多瓦=>小马广场
鸡西=>兴凯湖,珍宝岛,麒麟山风景区,月牙湖,哈达河风景区,莲花泡风景区,北大荒书法艺术长廊
泸沽湖=>泸沽湖,里格岛,观景台,狮子山,里务比岛,大落水村,小落水村,扎美寺,永宁温泉,黑娃俄岛,阿夏幽谷,吉意溶洞,永宁坝子,者波
巴塞尔=>马尔克特广场
维罗纳=>朱丽叶故居,香草广场,绅士广场,罗密欧故居,古堡美术馆,阿雷纳圆形竞技场,圣安那斯塔斯教堂
高雄=>爱河,西子湾,高雄港,打狗英国领事馆,猫鼻头,寿山,佛光山,莲池潭,海水浴场,孔庙,旗津半岛,城市光廊,驳二艺术特区,高雄历史博物馆
保山=>北海湿地
英戈尔施塔特=>英戈尔施塔特购物村
慕尼黑=>新天鹅堡,奥林匹克公园,新市政厅,圣母教堂,英国公园,玛利亚广场,中国塔,安联体育场,皇宫区,国王广场,宝马大厦,圣彼得教堂
爱媛县=>松山城
淄博=>沂源九天洞
琅勃拉邦=>香通寺,浦西山,王宫博物馆,维苏那拉特寺
银川=>西夏王陵,贺兰山岩画,鼓楼,海宝塔,玉皇阁,南关清真大寺,拜寺口双塔,华夏珍奇艺术城,镇北堡西部影视城,苏峪口国家森林公园,中华回乡文化园,纳家户清真寺,宏佛塔,三关口明长城,鹤泉湖
扬州=>瘦西湖,个园,何园,大明寺,古运河,文昌阁,汪氏小苑,凤凰岛,史公祠,琼花观,高旻寺,石塔,观音山,茱萸湾,冶春园,双博馆,仙鹤寺,文峰塔,普哈丁墓,新天地,瓜洲古渡,卢氏盐商住宅,二分明月楼,天沐温泉
甘孜=>海螺沟温泉
温州=>仙居桥
华欣=>三百峰国家公园
佳木斯=>洪河自然保护区
南京=>夫子庙,中山陵,玄武湖,明孝陵,总统府,秦淮河,灵谷寺,雨花台,鸡鸣寺,明古城墙,鼓楼,梅花山,长江大桥,栖霞山,瞻园,阅江楼,乌衣巷,莫愁湖,朝天宫,高淳,汤山温泉,紫霞湖,栖霞寺,燕子矶,梅园新村,南京大屠杀纪念馆,牛首山,珍珠泉,美龄宫,南京博物院,中山植物园,海底世界,白鹭洲,李香君故居,明故宫遗址,千佛岩,孙中山纪念馆,长江二桥,汤山温泉别墅,郑和墓,定林寺,渡江胜利纪念碑,石柱林,红山森林,淳溪老街,渡江胜利纪念馆,保圣寺塔,静海寺
岳阳=>杜甫墓
青海湖=>青海湖,鸟岛,日月山,油菜花,茶卡盐湖,原子城,沙岛,海心山,金银滩草原,橡皮山,二郎剑景区,孤插山,黑马河乡,泉湾,伏俟城遗址
文山=>西华公园
冈山县=>仓敷美观地区
阿拉善左旗=>广宗寺,通湖湿地
天柱山=>仙桃石
天津=>五大道,古文化街,盘山,鼓楼,天后宫,南市食品街,劝业场,黄崖关,独乐寺,天津之眼,石家大院,大沽口,广播电视塔,水上公园,西开教堂,杨村,望海楼,广东会馆,海滨浴场,动物园,八仙山,大悲禅院,静园,东丽湖,外滩公园,梁启超故居,自然博物馆,霍元甲故居,周恩来邓颖超纪念馆,潮音寺,中国古城堡,中上元古界,牡蛎滩,宝成博物苑,庆王府,中心公园,西沽公园,北宁公园,开滦矿务局大楼,李烛尘故居,河西公园,南开区烈士陵园,吉鸿昌故居,天尊阁
纳库鲁=>纳库鲁湖
长岛=>九丈崖,月牙湾,万鸟岛,仙境源,望夫礁,宝塔礁,龙爪山,天后宫,石帆礁
卡帕多奇亚=>地下城
维尔茨堡=>主教宫,旧美因桥,圣基里安大教堂
驻马店=>嵖岈山风景区,梁祝故里,金顶山,杨靖宇将军旧居
西澳=>毕西顿
瓦莱塔=>大王宫
宜昌=>屈原故里
布尔津=>禾木,白哈巴,喀纳斯湖,贾登峪,五彩滩,白桦林,白沙湖,友谊峰,禾木桥,图瓦村,白湖,黄金大道,吐鲁克岩画,那仁夏牧场
阿斯旺=>古采石场,阿斯旺大坝,阿布辛贝神庙,努比亚村,拉美西斯二世神庙,哈索尔神庙,康翁波神庙,阿嘎可汗王陵
维也纳=>多瑙河,美泉宫,森林,国家歌剧院,音乐厅,霍夫堡宫,环城大道,克恩顿大街,英雄广场,茜茜公主博物馆,国会大厦,动物园,奥地利国家美术馆,多瑙公园,市立公园,卡尔广场,皇家马术学校,圣麦斯公墓,地下童话王国
九江=>落星墩
古北口镇=>司马台
嵊泗=>基湖沙滩,大悲山,六井潭,南长涂,小洋山,枸杞岛,洋山港,花鸟灯塔,花鸟岛,嵊山岛,黄龙岛,大洋山,枸杞沙滩,小西天,小洋石龙,妈祖庙
武威=>海藏寺
日喀则=>热拉雍仲林寺
云浮=>金水台温泉
马德里=>王宫,西班牙广场,斗牛场,托莱多,太阳门广场,马约尔广场,塞戈维亚,普拉多博物馆,丽池公园,东方广场,莱昂,布尔戈斯,阿兰胡埃斯,塔楼,市政广场,阿维拉,萨拉曼加,皇家剧院,国家艺术中心,欧洲门
巴彦淖尔=>乌拉特草原
曲靖=>胜境关
阿拉善盟-额济纳=>黑水城
新昌=>天烛湖
丰台区=>大葆台
佛山=>东华里
洛桑=>奥林匹克博物馆,圣母大教堂,圣佛朗索瓦广场,罗马博物馆
漠河=>北极村,胭脂沟,洛古河,松苑,火灾纪念馆,李金镛祠堂
不老屯镇=>云峰山
大兴县=>榆垡万亩森林公园
罗马=>君士坦丁凯旋门,西班牙广场,剧场,万神殿,威尼斯广场,梵蒂冈宫殿,圆形竞技场,比萨斜塔,圣彼得教堂,歌剧院,真理之口,圣彼得广场,古罗马广场,圣天使城堡,纳沃纳广场,卡拉卡拉浴场,人民之门,特莱维喷泉,西斯廷礼拜堂,女王之路,马杰奥尔,勃鲁格泽,国立博物馆,展览室,国立绘画馆
澎湖=>吉贝屿
长春=>净月潭,莲花山滑雪场,长影世纪城,南湖公园,般若寺,文化广场,伪满皇宫博物院,吊水壶,农安古塔,双阳湖,长春世界风景园,长春世界雕塑公园,卡伦湖度假村
乌兰察布=>黄花沟
伊春=>茅兰沟,回龙湾,恐龙博物馆,植物园,林海奇石,日月峡滑雪场,溪水国家森林公园,金山鹿苑,风情园,梅花山滑雪场,五营丰林,恐龙地质公园,木雕园
布尔诺=>绿色广场
罗凡涅米=>冰雪城堡
盐城=>宋曹故居
歙县=>渔梁
布鲁塞尔=>大广场,市政厅,小于连,古战场,漫画博物馆,原子塔,天鹅咖啡馆,国王大厦
雷根斯堡=>石桥
和田=>改水纪念碑
包头=>阿尔丁广场
甘南=>郎木寺,拉卜楞寺,桑科草原,米拉日巴佛阁,贡唐宝塔,扎尕那,尕海湖,则岔石林,腊子口,大峪沟,黄河首曲,莲花山,冶海,西仓寺,达宗湖
悉尼=>歌剧院,蓝山,悉尼大桥,达令港,岩石区,皇家植物园,邦迪海滩,海德公园,悉尼海港,猎人谷,鱼市场,中国花园,帕丁顿,市政厅,曼利,水族馆,梦幻世界,牛津街,野生动物世界,史蒂芬港,卧龙冈,女王大厦,动力博物馆,中央海岸,杰克逊港,澳洲博物馆,塔龙加动物园,屈臣氏湾,悉尼博物馆,伊莉莎白海湾宅邸,国立海洋博物馆,军营博物馆,奥林匹克村
九华山=>花台景区
泸州=>龙透关
阿布戴尔国家公园=>树顶酒店
洞头=>大瞿岛
无锡=>鼋头渚,灵山大佛,蠡园,锡惠公园,南禅寺,太湖仙岛,寄畅园,古运河,东林书院,惠山寺,灵山梵宫,龙头渚,无锡影视基地,惠山古镇,无锡博物院,梅园横山,薛家花园
阿勒泰=>阿尔泰山,额尔齐斯河,桦林公园,卡拉麦里,阿拉善温泉,蝴蝶沟,五指泉,小东沟
崇文区=>游乐园
广州=>博物馆,上下九,白云山,沙面,陈家祠,越秀公园,动物园,中山纪念堂,中山大学,流溪河,烈士陵园,百万葵园,白水寨,镇海楼,海洋馆,西关大屋,光孝寺,香江野生动物世界,小洲村,黄花岗,石门,云台花园,南越王墓,六榕寺,城隍庙,五仙观,从化温泉,宝墨园,芙蓉嶂,南海神庙,华南植物园,科学中心,天湖,荔湾湖,长隆水上乐园,暨南大学,余荫山房,石室圣心,天河公园,怀圣寺,海幢寺,华南理工大学,纯阳观,仁威庙,蒲洲花园,丹水坑,北回归线广州标志塔,大角山炮台,平安大戏院,文化公园
圣淘沙=>海事博物馆
戎=>博舒埃广场
菏泽=>曹州百花园,古今园,曹州书画院,金山旅游区
黑河=>五大连池,大黑河岛,药泉山,瑷珲古城,北泉,胜山狩猎场
普兰提斯=>帕拉波尔蒂尼教堂
济南=>大明湖,千佛山,泉城广场,黑虎泉,趵突泉公园,灵岩寺,珍珠泉,红叶谷,四门塔,动物园,五峰山,跑马岭,五龙潭公园,泉城公园,金线泉,山东省博物馆,华阳宫,清照词园,济南野生动物园,解放纪念馆,环城公园
呼伦贝尔=>呼伦贝尔,海拉尔,额尔古纳,室韦,莫尔道嘎,金帐汗,扎兰屯,红花尔基,呼和诺尔草原,海拉尔纪念园,吊桥公园,鄂伦春博物馆,鄂温克博物馆,嘎仙洞,柴河,达尔滨湖,绰源,驯鹿之乡
台场=>台场丰田汽车馆
连城=>竹安寨
南麂山列岛=>大沙岙
永州=>上甘棠村
德州=>苏禄王墓
安庆=>天仙河
仰光=>瑞光大金塔,昂山市场,茵雅湖,司雷宝塔,唐人街,卡拉威宫,乔达基塔,丁茵水中佛塔
群马县=>鬼押出园
且末=>木孜塔格峰
兰州=>白塔山,五泉山,黄河铁桥,甘肃省博物馆,兴隆山,水车博览园,碑林,黄河母亲雕塑,城隍庙,吐鲁沟,庄严寺,雁滩公园,石佛沟,白云观,白衣寺塔,仁寿山
洛伊克巴德=>盖米山口
孟买=>鸟葬场
安曼=>阿姆拉城堡
兴义=>万峰林,马岭河峡谷,万峰湖,刘氏庄园,三岔河,泥凼石林,深谷湖
班贝格=>新王宫
木兰围场=>将军泡子,五彩山,桦木沟,西大泡子
怀柔区=>红螺寺
雅加达=>安佐尔梦幻公园,大清真寺,民族独立纪念碑
桂林=>漓江,银子岩,龙脊梯田,两江四湖,冠岩,独秀峰,七星公园,芦笛岩,叠彩山,伏波山,象山公园,灵渠,古东瀑布,桃花江,猫儿山,八角寨,龙胜温泉,草坪,日月双塔,大圩古镇,尧山,乐满地度假,南溪山公园,靖江王陵,资江漂流,漓江民俗风情园,黄洛瑶寨,宝鼎瀑布,穿山公园,熊虎山庄,银水侗寨,桂林植物园,大岭山桃园,桂林博物馆,红溪,李宗仁故居,五排河
增城=>雁塔
宁德=>福瑶列岛
东川=>红土地
帕罗斯岛=>帕罗斯岛
圣莫里茨=>考尔维利亚
南麂列岛=>国姓澳
都江堰=>建福宫
江阴=>华西金塔
襄阳=>绿影壁
安康=>凤凰山森林公园
天水=>大地湾遗址
琉森=>斯普罗伊尔桥
巴斯=>皇家新月楼
日惹=>普兰班南
乌海=>胡杨岛
爱丁堡=>爱丁堡城堡,Princess Street,威士忌中心,圣十字架宫,卡尔顿山,罗斯林教堂,格拉斯广场,圣吉尔斯大教堂,皇家英里大道,苏格兰博物馆,司各特纪念碑
爱琴海诸岛=>基克拉泽斯群岛
中卫=>沙坡头,腾格里沙漠,鼓楼,中卫高庙,黄河水车,寺口子,双狮山,水稍子
黄山市=>黄山,屯溪老街,翡翠谷,太平湖,唐模,花山谜窟,潜口,牯牛降,醉温泉,程氏三宅,野生猴谷,屯溪老大桥
万隆=>覆舟火山
东营=>清风湖公园
济宁=>浣笔泉
都匀=>斗篷山,荔波樟江,猴子沟
加勒=>荷兰城堡
自贡=>金花桫椤自然保护区
龙岩=>高北土楼群,长汀,永定土楼,客家土楼民俗文化村,南溪土楼群,初溪土楼群,古田会议旧址,龙硿洞,梅花山,中川古村落,连城冠豸山,培田古民居,永福,蛟洋文昌阁,九鹏溪,梁野山,毛泽东才溪乡调查纪念馆
凤凰古城=>凤凰古城,沱江,虹桥,吊脚楼,黄丝桥古城,沈从文故居,奇梁洞,东门城楼,杨家祠堂,万寿宫,南华山,都罗寨,崇德堂,古城博物馆,腊尔山,西门峡漂流,沙湾景区,苗疆长城，南方长城
旧金山=>金门大桥,渔人码头,唐人街,硅谷,联合广场,斯坦福大学,金门公园,恶魔岛,艺术宫,Yosemite,北滩,市政大厅,诺布山,阿拉莫广场,加州伯克利大学,旧金山动物园,科伊特塔,超美金字塔,九曲花街
江门=>开平碉楼,台山,圭峰山,立园,小鸟天堂,梁启超故居,梅家大院,帝都温泉,玉台寺,歇马举人村,喜运来温泉,现代农业基地
昆明=>地下倒石林
开平=>赤坎欧陆风情街
亚喀巴=>罗马剧院
塞维利亚=>大教堂,斗牛场,王宫,圣雷安德罗,黄金塔,加的斯,塞维利亚大学,路易莎公园,大主教宫
法兰克福=>大教堂,罗马广场,歌德故居,海德堡大学,展览中心,罗腾堡,老歌剧院,奥格斯堡,金融区,电影博物馆,施特德尔美术馆,饕餮胡同
四姑娘山=>长坪沟,双桥沟,海子沟,二姑娘山,大姑娘山,三姑娘山,四峰
停泊岛=>大停泊岛
德累斯顿=>圣母教堂,王宫
兴安盟=>五里泉
吉安=>青原山
绵阳=>七曲山大庙,窦圌山,北川地震遗址,富乐山,罗浮山,药王谷,王朗自然保护区,平武报恩寺,科学城,佛爷洞
莆田=>湄屿潮音,瑞云山森林公园,梅妃故里
门头沟区=>小龙门森林公园
蓬莱=>太平楼
曼德勒=>曼德勒山,曼德勒皇宫,因瓦古城,马哈牟尼佛塔,敏贡古城,实皆古城
芜湖=>汀棠公园
钦州=>三娘湾,七十二泾,六峰山,王岗山,大芦村古宅
哈尔施塔特=>骸骨教堂
北马里亚纳=>鸟类保护区
朔州=>神头泉
铜仁=>梵净山,九龙洞,南长城,石阡温泉,十里锦江,夜郎谷
纽约=>华尔街,帝国大厦,时代广场,中央公园,唐人街,自由女神像,大都会博物馆,第五大道,洛克菲勒中心,联合国总部,自然历史博物馆,布鲁克林大桥,格林威治村,西点,Ground Zero,华盛顿广场,纽约市政厅,峭石之巅,中央火车站,海鸥帆船
沧州=>沧州铁狮子
九州=>豪斯登堡,阿苏火山,新地中华街,哥拉巴公园,熊本城,青岛,柳川,天守阁,豆田町
阿克苏=>塔里木河,托木尔峰,神木园,燕泉公园
神奈川县=>箱根,中华街,大涌谷,芦之湖,登山斜面电车
卡尔加里=>壮姆海勒
武夷山=>大红袍,九曲溪,天游峰,一线天,虎啸岩,水帘洞,武夷宫,大王峰,玉女峰,青龙大瀑布,黄岗山,下梅,华东一漂,龙川大峡谷,云窝,隐屏峰,玉龙谷,武夷山博物馆,鹰嘴岩,宋街,遇林亭,十八寨,三仰峰,万春园,朱熹纪念馆,响声岩,大竹岚,幔亭峰,天心岩,古汉城,灵岩洞,天柱峰,上下水龟,仙钓台,灵岩
雷克亚未克=>珍珠楼
锡林郭勒=>锡林郭勒,乌珠穆沁,贝子庙,元上都遗址,平顶山,金莲川,了望山,锅盔山,乌里雅斯太山,白音锡勒牧场,玄石坡,滦源殿,灰腾草原
泰州=>溱潼会船
太仓=>乐荫园
镇江=>金山,焦山,金山寺,北固山,甘露寺,句容,茅山,宝华山,慈寿塔,天下一泉,北固亭,定慧寺,芙蓉楼,多景楼,招隐寺,白龙洞,南山风景区,韦岗温泉,西津古渡街,万佛塔,英国领事馆旧址,三诏洞,赛珍珠故居,救生会,仙人洞,报恩塔,绍隆寺,乾元观
石嘴山=>青山公园
圣托里尼=>圣托里尼
忻州=>奇村温泉疗养区
石林=>芝云洞地下石林公园
临安=>柘林瀑
米科诺斯岛=>博物馆
武陵源=>杨家界
墨尔本=>大洋路,亚拉河,皇家植物园,联邦广场,疏芬山,维多利亚艺术中心,库克船长小屋,维多利亚女皇市场,皇家展览馆,菲力浦岛,墨尔本水族馆,墨尔本博物馆,墨尔本动物园,皇冠逍遥之都,可谟宅邸,国王公园,菲兹洛伊花园,丽爱图塔观景台,墨尔本板球场
龙虎山=>仙水岩,天师府,崖墓,上清古镇,象鼻山,无蚊村,天门山,十不得
贵港=>东塔
拉萨=>鲁孜峰
巴拉顿湖区=>蒂豪尼半岛
维多利亚=>唐人街,布查特花园,帝后饭店,省议会大厦,雷鸟公园,水晶花园,小人国,皇家伦敦蜡像博物馆
中山=>五桂山,中山温泉,逍遥谷,孙中山纪念堂,孙中山故居纪念馆
博卡拉=>费瓦湖,桑冉库特,鱼尾山庄,戴维瀑布
科隆=>科隆大教堂,市政厅,巧克力博物馆,德意志之角,路德维希博物馆,德国博物馆,应用艺术博物馆
上海=>外滩,世博园,城隍庙,南京路,豫园,东方明珠,朱家角,陆家嘴,淮海路,佘山,植物园,金茂大厦,衡山路,苏州河,静安寺,环球金融中心,美术馆,野生动物园,中山公园,大观园,多伦路,上海博物馆,卢浦大桥,太阳岛,淀山湖,芦潮港,外白渡桥,世纪公园,玉佛寺,鲁迅故居,欢乐谷,滨江大道,东方绿舟,上海老街,复旦大学,文庙,科技馆,锦江乐园,枫泾古镇,鲁迅公园,复兴公园,人民公园,上海大剧院,一大会址,大洋海底世界,杜莎夫人蜡像馆,龙华寺,八万人体育场,三甲港,华亭东石塘
日照=>太公岛,桃花岛,五莲山,九仙山,浮来山,竹洞天,任家台,刘家湾赶海园,海滨森林公园,万平口海滨,海洋馆,世帆赛基地,河山,二海水浴场,尧王城遗址,大青山,龙门岗
昆山=>莲池禅院
乌镇=>茅盾故居,修真观,逢源双桥,百床馆,财神湾,茅盾纪念馆,昭明书院,古戏台,乌将军庙,余榴梁钱币馆,香山堂,访卢阁,水上戏台,叙昌酱园,灵水居,元宝湖,草木本色染坊,北湿地,应家桥,茅盾陵园,江浙分府,关帝庙,三寸金莲
东莞=>可园,虎门大桥,威远炮台,沙角炮台,隐贤山庄,粤晖园,鸦片战争博物馆,展览馆,绿色世界,棕榈谷水城,冠和博物馆,旗峰公园,长安公园
华盛顿=>白宫,国会大厦,林肯纪念堂,华盛顿纪念碑,五角大楼,乔治城,航空航天博物馆,国会图书馆,美术馆,最高法院,联邦调查局,杰弗逊纪念堂,国家公墓,历史博物馆,植物园,国家档案馆
常州=>史良故居
甘孜县=>甘孜寺
千岛湖=>白云溪,九龙溪,猴岛,九咆界,森林氧吧,鸵鸟岛,神龙岛,龙山岛,三潭岛,梅峰观岛,黄山尖,千岛湖石林,月光岛,芹川村,桂花岛,蜜山岛,金峰峡谷,天池岛
康庄镇=>康西草原
伯尔尼=>熊池
唐山=>喜峰口
若尔盖=>降扎温泉
马尼拉=>黎刹公园,百胜滩,马尼拉大教堂,圣奥古斯丁教堂,圣地亚哥城堡,椰子宫,菲律宾文化中心,达雅台,华人公墓,卡撒马尼拉博物馆
民丹岛=>民丹山,大象公园
贺兰=>贺兰山岩画
武当山=>雷神洞
连云港=>花果山,渔湾,连岛海滨浴场,水帘洞,孔望山,三元宫,东海温泉,锦屏山,东磊,保驾山,南天门,东西连岛,抗日山烈士陵园,龙洞,羽山,延福观,屏竹禅院,一线天,镜石,孔子会齐侯处,徐福村,仙人屋,万佛洞,高公岛凰,悟正庵
南昌=>小平小道
伯罗奔尼撒=>宙斯神庙
克拉科夫=>王宫
霍克湾=>克拉吉庄园
乌鲁木齐=>国际博览中心
塞班岛=>日出神社
曼谷=>湄南河,玉佛寺,四面佛,卧佛寺,唐人街,大王宫,郑王庙,金佛寺,国家博物馆,佛统,水上集市,鳄鱼潭,马车博物馆,民主纪念碑,王家田广场,金山寺,旧国会大厦,云石寺,泰王五世行宫,律实动物园,王室之舟
喀什=>莫尔佛塔
宁波=>它山堰
德岛县=>蔓桥
卢森堡=>卢森堡大峡谷
九寨沟风景区=>五花海
牛津=>叹息桥,牛津城,高街,彼斯特,基督教堂学院,博德莱安图书馆,大学博物馆,玉米
焦作=>峰林峡
威尼斯=>圣马可广场,大运河,叹息桥,钟楼,圣马可大教堂,总督府,利多岛,圆柱,布拉诺岛,雷雅托桥,学院美术馆,科雷尔博物馆,雷佐尼科宫,佩沙罗宫,圣保罗教堂,海洋历史博物馆,圣乔凡尼保罗大教堂
阜新=>海棠山,瑞应寺,乌兰木图山,三塔沟,塔子沟,宝力根寺
锦州=>笔架山,医巫闾山,辽沈战役纪念馆,青岩寺,广济寺,奉国寺,北镇庙,北普陀山,万佛堂石窟,崇兴寺双塔
苏黎世=>班霍夫大街,歌剧院,国家博物馆,中国园,巴登,阅兵场,奥古斯丁巷,格罗斯大教堂,妇女大教堂,百利工厂店
泰顺=>东洋桥
圣彼得堡=>冬宫,夏宫,涅瓦大街,普希金城,喀山大教堂,阿芙乐尔号,斯莫尔尼宫,青铜骑士,庄园,尼古拉一世,彼得要塞,俄罗斯博物馆,涅夫斯基修道院,海军部大厦,海军教堂,斯莫尔尼修道院
科罗拉多州=>丹佛
卢克索=>帝后谷
加尔各答=>印度博物馆
毛里求斯=>庞普勒穆斯植物园
商丘=>商丘张飞寨
尼斯=>蒙特卡罗,歌剧院,埃兹,芒通,亲王宫,金梅德新大道,马蒂斯美术馆,当代美术馆,东正教大教堂
大庆=>衍福寺双塔
夏威夷=>瓦胡岛,大岛,珍珠港,毛伊岛,威基基海滩,可爱岛,恐龙湾,火山国家公园,大风口,拉奈岛,摩洛凯岛,Polynesian,黑沙滩,蕨类植物洞,卡怀亚哈奥教堂,卡皮奥拉妮公园,纳帕利海岸,古兰尼牧场,热带植物园,卡阿纳帕利沙滩
莫斯科=>红场,克里姆林宫,列宁墓,莫斯科大学,莫斯科河,莫斯科地铁,新圣女公墓,阿尔巴特街,胜利广场,凯旋门,麻雀山,全俄展览中心,美术馆,亚历山大花园,历史博物馆,俄罗斯大剧院,普希金广场,基督救世主大教堂,电视塔,三圣大修道院,国立百货商场,奥斯坦基诺庄园
新德里=>甘地陵
都柏林=>凤凰公园,莫赫悬崖,圣殿酒吧区,健力士黑啤展览馆,作家博物馆,圣帕特里克大教堂,圣史蒂芬公园,都柏林城堡
雅典=>卫城,宪法广场,巴特农神庙,宙斯神庙,哈德良拱门,伊瑞克提翁神庙,国家考古博物馆,议会大厦,神山,拜占庭博物馆,布拉卡区,奥林匹克竞技场,狄奥尼索斯剧场
佬沃=>马可斯行宫
格尔木=>格尔木河
乐山=>九曲栈道
吴忠=>吴忠清真寺
达尼丁=>奥玛鲁
深圳=>世界之窗,欢乐谷,东部华侨城,锦绣中华,红树林,小梅沙,南澳,东冲,会展中心,野生动物园,梧桐山,中英街,仙湖植物园,杨梅坑,海上世界,东门老街,香蜜湖,七娘山,桔钓沙,月亮湾,莲花山公园,大芬油画村,华强北路,羊台山,欢乐干线,浪骑游艇会,人民公园,南岭村,荔香公园,东江纵队纪念馆
吉隆坡=>唐人街,独立广场,国家清真寺,黑风洞,吉隆坡塔,手工艺品,国家博物馆,王宫,湖滨公园,波德申,老城区,国会大厦,星星丘,国家石油公司双塔大楼,吉隆坡火车总站,国家英雄纪念碑,独立体育场,国家艺术馆,农业公园
安阳=>红旗渠,曹操高陵,岳飞庙,文峰塔,殷墟博物苑,袁林,林虑山,中国文字博物馆,冰冰背,马氏庄园,二帝陵
阿努拉德普勒=>艾苏卢姆尼亚石庙
红海和西奈半岛=>萨法加
加利利湖=>五饼二鱼堂
怀柔县=>箭扣
日土=>班公错
华沙=>圣十字教堂,瓦津基公园,王宫城堡
台北=>西门町,国立故宫博物院,士林夜市,阳明山,野柳,国父纪念馆,九份,中正纪念堂,诚品书店,士林官邸,龙山寺,迪化街,渔人码头,台北动物园,新北投,孔庙,筠园,故事馆,猫空茶园
新乡=>陈桥驿风景胜区
普陀山=>紫竹林,百步沙,千步沙,不肯去,洛迦山,梵音洞,潮音洞,磐陀石,普济禅寺,南天门,心字石,朝阳洞,法雨禅寺,听法石,多宝塔,慧济禅寺,海印池,九龙殿,南海观音立像,短姑圣迹,云扶石,海岸牌坊,宝陀讲寺,妙湛塔,杨枝禅院,海会桥
布拉格=>查理大桥,布拉格城堡,天文钟,黄金巷,旧城广场,克鲁姆洛夫,卡罗维发利,国家博物馆,火药塔,圣乔治教堂,圣维特大教堂,犹太区,画廊,皮尔森,旧市政厅,旧皇宫,圣尼古拉教堂,百威小镇,约瑟夫城
新竹=>湖口老街
河内=>胡志明博物馆
湛江=>龙海天
特拉维夫=>雅法,海法,加利利湖,凯萨利阿
热那亚=>佛拉里广场
玉溪=>三圣宫
怒江=>迪麻洛
义乌=>古月桥
首尔=>明洞,东大门,景福宫,仁寺洞,南山,乐天世界,青瓦台,清溪川,昌德宫,梨泰院,韩屋村,华克山庄,宗庙,爱宝乐园,南怡岛,德寿宫,昌庆宫,大学路,国立公园,游乐场,世界杯体育场,国立民俗博物馆,首尔广场,云岘宫,韩国之家,国立中央博物馆,北村韩屋村,战争纪念馆,樱花大道,奥林匹克公园,奉恩寺,光化门广场,罗德奥街,华城行宫,爱舞动,毕加索街,青瓦台舍廊房,三清洞文化街,国立剧场
瓜里尔=>瓜里尔皇宫
宿迁=>嶂山森林公园
三亚=>亚龙湾,大东海,三亚湾,天涯海角,蜈支洲岛,南山寺,南田温泉,西岛,大小洞天,椰梦长廊,海棠湾,锦母角,蝴蝶谷,南山文化,观日岩,海上观音,贝壳馆,南湾猴岛,鹿回头公园,分界洲岛,亚龙湾中心广场,热带天堂森林公园,小东海,呀诺达雨林,妈祖庙,风情园,落笔洞,爱心大世界,白鹭公园,崖州古城,美丽之冠文化会展中心,神州一泉,南端点火台,京润珍珠博物馆,凤凰岭公园
榆林=>红石峡
北海=>银滩,涠洲岛,北部湾广场,斜阳岛,星岛湖,海洋之窗,珠海路,海滩公园,海底世界,冠头岭,南珠宫,白龙城,外沙岛,大士阁,东坡亭,文昌塔,英罗红树林,海角亭,古汉墓,普度震宫,海底彩带
苏瓦=>德斯登花园
金边=>王宫,国家博物馆,杀人场,独立纪念碑,万谷湖,监狱博物馆,乌那隆寺,塔山寺,四臂河
关岛=>圣母玛利亚教堂
萍乡=>武功山
海南西线=>东坡井
珠海=>情侣路,海泉湾,东澳岛,圆明新园,御温泉,外伶仃岛,荷包岛,淇澳岛,横琴蚝,石景山,飞沙滩,梅溪牌坊,庙湾岛,金台寺,珠海博物馆,竹仙洞,澳门环岛游,梦幻水城,金海滩,桂山岛,石博园,白藤湖,九洲岛,四大佛山,万象城
纽伦堡=>圣劳伦茨教堂
苏州=>拙政园,虎丘,观前街,狮子林,寒山寺,留园,山塘街,苏州博物馆,平江路,东山,网师园,盘门,金鸡湖,沧浪亭,苏州乐园,灵岩山,十全街,耦园,石路,木渎古镇,严家花园,天平山,三山岛,玄妙观,虹饮山房,石湖,香雪海,榜眼府,怡园,石公山,甪直古镇,静思园,穹窿山,重元寺,林屋洞,明月湾,环秀山庄,陆巷古村,莲花岛,艺圃,西园寺,枫桥景区,昆曲博物馆,宝带桥,沈宅,铁铃关,丝绸博物馆,曲园,盛泽,天池山
九寨沟县=>九寨沟
蒲甘=>阿南达寺,瑞山都塔,他冰瑜塔,醯路弥路寺,达玛央吉塔
那曲=>比如骷髅墙
金华=>双龙洞,冰壶洞,金华山,朝真洞,寿仙谷,黄大仙祖宫,桃源洞,金华观,八咏楼,仙华山,太平天国侍王府,天宁寺,江南一家,五峰,神丽峡,高姥山,仙瀑洞
吐鲁番=>火焰山,葡萄沟,交河故城,高昌故城,苏公塔,艾丁湖,吐鲁番博物馆,柏孜克里克千佛洞,库姆塔格沙漠,郡王府,维吾尔古村,麻扎村,阿斯塔那古墓群,苏公塔礼拜寺
台南=>安平古堡
库萨达斯=>以弗所古城
黎平=>肇兴侗寨,天生桥,翘街,地坪风雨桥,红军桥,程阳风雨桥,飞龙洞,南泉山,仙人岩,肇兴鼓楼群
采尔马特=>马特宏峰冰川天堂,戈尔内格拉特,洛特峰,富鲁格冰河
衡山=>穿岩诗林
天宁岛=>日本海军司令通信部遗址
湖北=>武汉站
那不勒斯=>那不勒斯主教大教堂
兵库县=>姬路城
马尔代夫=>满月岛
北海道=>小樽,函馆,洞爷湖,白色恋人,地狱谷,钏路,富田农场,旭川市,昭和新山,钟楼,旭山动物园,时计台,薄野,旭岳,硫磺山,知床五湖,藻岩山,有珠火山,大沼公园,地球岬,小樽音乐盒堂,彩香之里,大仓山,樱花道
黄龙泉=>凤栖山
舟山=>桃花岛,东极岛,安期峰,秀山岛,桃花峪,鹿栏晴沙,马岙,桃花港,大佛岩,千步金沙,蚂蚁岛,悬鹁鸪岛,定海古城,观音山,石壁残照,黄杨尖
柏林=>柏林墙,巴黎广场,国会大厦,动物园,市政厅,柏林大教堂,博物馆岛,椴树下大街,电视塔,查理检查站,御林广场,纪念教堂,联邦总理府,奥林匹克体育场,国立美术馆,莱特车站,宫殿广场,蒂尔加藤,爱乐厅
腾冲=>热海,腾冲火山群
郴州=>莽山
广安=>邓小平故居陈列馆
蒙特勒=>日内瓦湖,西庸城堡
沙捞越=>古晋,大马海岸,西布
汕尾=>龟龄岛
里斯本=>罗卡角,辛特拉
惠灵顿=>博物馆,国会大厦,动物园,奥塔里植物园
长滩岛=>白沙滩,普卡海滩,蝙蝠洞,卢霍山,罗尔遗产博物馆
肇庆=>鼎湖山,七星岩,庆云寺,西江,龙母祖庙,世外桃源,燕岩,梅庵,龙山,德庆学宫,阅江楼,包公祠,丽谯楼,竹海大观,九龙湖
阿拉善右旗=>曼德拉山岩画,巴丹吉林沙漠
埃伊尔斯塔奇=>东部峡湾
嘉义=>阿里山森林铁路
贵阳=>青岩古镇,甲秀楼,黔灵公园,天河潭,花溪公园,红枫湖,河滨公园,息烽,文昌阁,镇山村,南江大峡谷,香纸沟,森林公园,百花湖,情人谷,高坡苗乡,香火岩,鱼洞峡,白云公园
铜川=>药王山,金锁关,香山,陈炉古镇,姜女祠,药王故里,福地湖
科堡=>科堡大剧院
大城=>拉嘉布拉那寺
清远=>慧光斜塔
安塔利亚=>公园
弗拉基米尔=>圣母升天大教堂
楚雄=>元谋土林
秦皇岛=>北戴河,山海关,南戴河,老龙头,黄金海岸,翡翠岛,老虎石,鸽子窝公园,野生动物园,角山,燕塞湖,孟姜女庙,仙螺岛,碧螺塔,联峰山,碣石山,中海滩,乐岛海洋公园,联峰山公园,背牛顶,集发观光园,山海关海洋水族馆,天马山摩崖石刻
东开普=>摩梭湾
科伦坡=>西吉利亚
长白山=>长白瀑布
巢湖=>东庵森林公园
清迈=>素贴山,帕辛寺,清曼寺,契迪龙寺,长康路,蒲屏皇宫,清迈国家博物馆,老清迈文化中心,界遥寺,桑甘烹村,清迈夜间动物园,清道山洞
肯尼亚山国家公园=>登山
雁荡山=>天窗洞
理塘=>毛垭草原
德令哈=>尕海湖
胡志明市=>湄公河,大叻,红教堂,堤岸,市政厅,古芝地道,中央邮局,历史博物馆,战争犯罪博物馆
爱知县=>电视塔,白鸟花园
运城=>永乐宫
西哈努克=>胜利海滩,索卡海滩,西哈努克山
梅州=>客家公园
芭堤雅=>珊瑚岛,东芭乐园,芭堤雅海滩,沙美岛,龙虎园,乔木提恩海滩,tiffany秀,罗永府,信不信由你博物馆
衢州=>钱江源
临夏=>滴珠山
沙芙豪森=>莱茵瀑布
曲阜=>孔庙,孔府,孔林,大成殿,杏坛,尼山,奎文阁,十三碑亭,孔子六艺城,少昊陵,微山湖,三堂,孟庙,周公庙,二堂,檐柱,石门山,论语碑苑,颜子林,洙泗书院
约翰内斯堡=>狮子园
广汉=>三星堆
马尔康=>卓克基土司官寨,大藏寺
恰纳卡莱=>特洛伊古城
北京=>故宫,颐和园,王府井,天坛,国家体育场,香山,十刹海,圆明园,北京大学,鼓楼,三里屯,雍和宫,恭王府,欢乐谷,植物园,大栅栏,南锣鼓巷,动物园,北海公园,798,国子监,琉璃厂,钟楼,海洋馆,清华大学,景山公园,居庸关,烟袋斜街,国家大剧院,天文馆,碧云寺,卧佛寺,毛主席纪念堂,人民大会堂,凤凰岭,正阳门,卢沟桥,爨底下,玉渊潭,首都博物馆,黑龙潭,石景山游乐园,紫竹院,世纪坛,中央电视塔,德胜门箭楼,戒台寺,悯忠寺,白岭关
巴厘岛=>乌布,海神庙,金巴兰,圣泉寺,乌鲁瓦图,库塔海滩,南湾,蓝点,努沙杜瓦,京打马尼,象窟,圣猴,巴图尔火山,布撒基寺,鸟园,图兰奔,爱咏河,乌布王宫,德格拉朗梯田,萨努尔海滩,马斯村,苏鲁村
大邑=>西岭雪山
三明=>万寿岩
色达=>五明佛学院
泰安=>泰山
迪拜=>沙漠,帆船酒店,阿布扎比,哈利法塔,棕榈岛,沙迦,世界岛,水上乐园,迪拜河,滑雪村,迪拜博物馆,扎耶德清真寺,香料市场,国家博物馆,巴斯塔基亚,朱梅勒清真寺,酋长购物中心,阿基曼,疯狂河道
同仁=>隆务寺,坎布拉,吾屯下寺,吾屯上寺,郭麻日寺,拉加寺,和日寺
萨尔茨堡=>大教堂,莫扎特故居,海尔布伦宫,霍亨萨尔茨堡,米拉贝尔宫,侬山修道院,粮食胡同,塞巴蒂安公墓
堪培拉=>国会大厦,格里芬湖,战争纪念馆,国家动物园,国家图书馆
宜春=>吴有训科教馆
延边=>仙景台
吉林市=>阿拉底朝鲜族村
大邱=>国立大邱博物馆
西昌=>黄联土林
香格里拉=>虎跳峡,松赞林寺,普达措,纳帕海,碧塔海,白水台,属都湖,白马雪山,独克宗,哈巴雪山,大峡谷,天生桥,三江并流,五凤山,赤土仙人洞,镇公堂,大宝寺
热浪岛=>嬷嬷茶屋
阿坝州=>梭磨河峡谷
汉中=>饮马池
伊兹拉岛=>伊兹拉岛
库奥皮奥=>贸易商城
密云县=>千尺珍珠瀑
黟县=>宏村,西递,南屏,塔川,关麓,卢村,木坑竹海,屏山,打鼓岭,归园,桃花源长廊,黄姑河
成都=>锦里,武侯祠,宽窄巷子,杜甫草堂,青羊宫,卧龙,文殊院,黄龙溪,金沙遗址,大熊猫基地,平乐古镇,天台山,欢乐谷,洛带古镇,昭觉寺,永陵,石象湖,大慈寺,宝光寺,望江楼公园,九龙沟,朝阳湖,建川博物馆,安仁古镇,国色天乡,植物园,望丛祠,极地海洋世界,猎人峰,古佛堰,九峰山,四川博物院,金堂云顶山,柳江古镇,南湖梦幻岛,蓥华山,龙池国家森林公园,龙门山地震遗址,汉旺地震遗址
塔城=>九莲泉
头沟区=>潭柘寺
伊斯坦布尔=>博斯普鲁斯海峡,蓝色清真寺,金角湾,圣索非亚大教堂,城墙,阿合麦特,克兹塔
玉树=>三江源,文成公主庙,结古寺,通天河,唐蕃古道,黄河源头,巴颜喀喇山,鄂陵湖,澜沧江,隆宝滩,天葬台,新寨玛尼城,尕尔寺,达那寺,贡萨寺
伦敦=>格林威治村
梅里雪山=>茨中
德格=>德格印经院
圣保罗=>巴西独立纪念碑
开封=>龙亭,铁塔,清明上河园,大相国寺,开封府,繁塔,包公祠,山陕甘会馆,宋都御街,禹王台,博物馆,天波杨府,延庆观,岳飞庙,中国翰园,樊楼,金明池,万岁山,刘少奇纪念馆,犹太教清真寺遗址
卢布尔雅那=>三桥
沙巴=>东姑阿都拉曼,西巴丹岛,山打根,水上清真寺,美人鱼岛,波令温泉,丹浓谷,京那巴鲁公园,纳闽岛,沙巴博物馆,迪加岛,农业公园
长野县=>松本城,松代
哥德堡=>哥塔广场,小博门码头,哥德堡市政厅广场
巴黎=>卢浮宫,凯旋门,凡尔赛宫,协和广场,香榭丽舍,艾菲尔铁塔,歌剧院,圣母院,市政厅,皇宫,荣军院,圣心教堂,卢森堡公园,先贤祠,三世桥,迪士尼,奥赛博物馆,唐人街,枫丹白露宫,新桥,旺多姆广场,西堤岛,香波堡,爱丽舍宫,杜伊勒里公园,孚日广场,小宫,战神广场,吉维尼,毕加索美术馆,蒙田大街,第戎,德芳斯新区,蒙玛特尔高地,蒂伊勒里
许昌=>优花木生产科技园区
海口=>印象海南岛,五公祠,万绿园,假日海滩,火山群,海瑞墓,东寨港,热带野生动植物园,钟楼,琼台书院,西秀海滩,金牛岭公园,海瑞故居,海口人民公园,海口博物馆,海底村庄,海南省博物馆,秀英古炮台
吉首=>山江苗寨
平谷区=>渔阳滑雪场
元阳=>元阳梯田
昌平区=>航空博物馆
韶关=>丹霞山,南华寺,南岭国家森林公园,梅关古道,必背瑶寨,曹溪温泉,金鸡岭,九泷十八滩,马坝人遗址,云门寺,古佛岩,韶石山,风采楼,狮子岩,广东大峡谷,仙人桥,满堂客家大围,三影塔,钟鼓岩,双峰寨,芙蓉仙洞
潍坊=>潍坊风筝博物馆
长江三峡=>三峡大坝,白帝城,小三峡,瞿塘峡,巫峡,西陵峡,夔门,石宝寨,葛洲坝,张飞庙,神农溪,小小三峡,神女峰,三游洞,灯影峡,黄陵庙,风箱峡,崆岭峡,白帝山
图尔=>舍农梭堡
通辽=>大乐林寺
宿雾=>圣佩特罗堡
林芝=>尼洋河